"filename", "language", "C#", "JSON", "comment", "blank", "total"
"c:\Users\mazap\Desktop\kvalifikācijas darbs\spēle\TheLostSwords\Assets\Scripts\.vs\ProjectSettings.json", "JSON", 0, 3, 0, 0, 3
"c:\Users\mazap\Desktop\kvalifikācijas darbs\spēle\TheLostSwords\Assets\Scripts\.vs\VSWorkspaceState.json", "JSON", 0, 7, 0, 0, 7
"c:\Users\mazap\Desktop\kvalifikācijas darbs\spēle\TheLostSwords\Assets\Scripts\AreaEnterance.cs", "C#", 26, 0, 2, 4, 32
"c:\Users\mazap\Desktop\kvalifikācijas darbs\spēle\TheLostSwords\Assets\Scripts\AudioManager.cs", "C#", 34, 0, 4, 8, 46
"c:\Users\mazap\Desktop\kvalifikācijas darbs\spēle\TheLostSwords\Assets\Scripts\CameraController.cs", "C#", 37, 0, 11, 14, 62
"c:\Users\mazap\Desktop\kvalifikācijas darbs\spēle\TheLostSwords\Assets\Scripts\CharacterStats.cs", "C#", 53, 0, 6, 10, 69
"c:\Users\mazap\Desktop\kvalifikācijas darbs\spēle\TheLostSwords\Assets\Scripts\DialogActivator.cs", "C#", 36, 0, 5, 8, 49
"c:\Users\mazap\Desktop\kvalifikācijas darbs\spēle\TheLostSwords\Assets\Scripts\DialogManager.cs", "C#", 65, 0, 8, 15, 88
"c:\Users\mazap\Desktop\kvalifikācijas darbs\spēle\TheLostSwords\Assets\Scripts\Enemy.cs", "C#", 38, 0, 1, 9, 48
"c:\Users\mazap\Desktop\kvalifikācijas darbs\spēle\TheLostSwords\Assets\Scripts\EssentialLoader.cs", "C#", 27, 0, 1, 6, 34
"c:\Users\mazap\Desktop\kvalifikācijas darbs\spēle\TheLostSwords\Assets\Scripts\ExitArea.cs", "C#", 38, 0, 6, 13, 57
"c:\Users\mazap\Desktop\kvalifikācijas darbs\spēle\TheLostSwords\Assets\Scripts\FadeUI.cs", "C#", 40, 0, 5, 8, 53
"c:\Users\mazap\Desktop\kvalifikācijas darbs\spēle\TheLostSwords\Assets\Scripts\GameManager.cs", "C#", 272, 0, 22, 48, 342
"c:\Users\mazap\Desktop\kvalifikācijas darbs\spēle\TheLostSwords\Assets\Scripts\GameMenu.cs", "C#", 186, 0, 28, 41, 255
"c:\Users\mazap\Desktop\kvalifikācijas darbs\spēle\TheLostSwords\Assets\Scripts\Item.cs", "C#", 59, 0, 1, 9, 69
"c:\Users\mazap\Desktop\kvalifikācijas darbs\spēle\TheLostSwords\Assets\Scripts\ItemButton.cs", "C#", 25, 0, 2, 3, 30
"c:\Users\mazap\Desktop\kvalifikācijas darbs\spēle\TheLostSwords\Assets\Scripts\Knockback.cs", "C#", 48, 0, 8, 6, 62
"c:\Users\mazap\Desktop\kvalifikācijas darbs\spēle\TheLostSwords\Assets\Scripts\LoadingEndScene.cs", "C#", 27, 0, 3, 3, 33
"c:\Users\mazap\Desktop\kvalifikācijas darbs\spēle\TheLostSwords\Assets\Scripts\LoadingNewScene.cs", "C#", 26, 0, 3, 5, 34
"c:\Users\mazap\Desktop\kvalifikācijas darbs\spēle\TheLostSwords\Assets\Scripts\LoadingScene.cs", "C#", 19, 0, 2, 3, 24
"c:\Users\mazap\Desktop\kvalifikācijas darbs\spēle\TheLostSwords\Assets\Scripts\MainMenu.cs", "C#", 35, 0, 3, 8, 46
"c:\Users\mazap\Desktop\kvalifikācijas darbs\spēle\TheLostSwords\Assets\Scripts\PickUpItem.cs", "C#", 26, 0, 2, 5, 33
"c:\Users\mazap\Desktop\kvalifikācijas darbs\spēle\TheLostSwords\Assets\Scripts\PlayerController.cs", "C#", 77, 0, 8, 19, 104
"c:\Users\mazap\Desktop\kvalifikācijas darbs\spēle\TheLostSwords\Assets\Scripts\PlayerData.cs", "C#", 28, 0, 1, 10, 39
"c:\Users\mazap\Desktop\kvalifikācijas darbs\spēle\TheLostSwords\Assets\Scripts\Pot.cs", "C#", 32, 0, 3, 7, 42
"c:\Users\mazap\Desktop\kvalifikācijas darbs\spēle\TheLostSwords\Assets\Scripts\QuestManager.cs", "C#", 47, 0, 19, 12, 78
"c:\Users\mazap\Desktop\kvalifikācijas darbs\spēle\TheLostSwords\Assets\Scripts\QuestMarker.cs", "C#", 40, 0, 2, 9, 51
"c:\Users\mazap\Desktop\kvalifikācijas darbs\spēle\TheLostSwords\Assets\Scripts\QuestObjectActivator.cs", "C#", 25, 0, 3, 8, 36
"c:\Users\mazap\Desktop\kvalifikācijas darbs\spēle\TheLostSwords\Assets\Scripts\Shop.cs", "C#", 108, 0, 4, 24, 136
"c:\Users\mazap\Desktop\kvalifikācijas darbs\spēle\TheLostSwords\Assets\Scripts\ShopKeeper.cs", "C#", 31, 0, 7, 9, 47
"c:\Users\mazap\Desktop\kvalifikācijas darbs\spēle\TheLostSwords\Assets\Scripts\SimpleEnemy.cs", "C#", 47, 0, 8, 9, 64
"Total", "-", 1552, 10, 178, 333, 2073