"filename", "language", "C#", "JSON", "comment", "blank", "total"
"c:\Users\mazap\Desktop\kvalifikācijas darbs\spēle\TheLostSwords\Assets\Scripts\.vs\ProjectSettings.json", "JSON", 0, 3, 0, 0, 3
"c:\Users\mazap\Desktop\kvalifikācijas darbs\spēle\TheLostSwords\Assets\Scripts\.vs\VSWorkspaceState.json", "JSON", 0, 7, 0, 0, 7
"c:\Users\mazap\Desktop\kvalifikācijas darbs\spēle\TheLostSwords\Assets\Scripts\AreaEnterance.cs", "C#", 26, 0, 2, 4, 32
"c:\Users\mazap\Desktop\kvalifikācijas darbs\spēle\TheLostSwords\Assets\Scripts\AudioManager.cs", "C#", 34, 0, 4, 8, 46
"c:\Users\mazap\Desktop\kvalifikācijas darbs\spēle\TheLostSwords\Assets\Scripts\CameraController.cs", "C#", 37, 0, 11, 14, 62
"c:\Users\mazap\Desktop\kvalifikācijas darbs\spēle\TheLostSwords\Assets\Scripts\CharacterStats.cs", "C#", 53, 0, 6, 10, 69
"c:\Users\mazap\Desktop\kvalifikācijas darbs\spēle\TheLostSwords\Assets\Scripts\DialogActivator.cs", "C#", 36, 0, 5, 8, 49
"c:\Users\mazap\Desktop\kvalifikācijas darbs\spēle\TheLostSwords\Assets\Scripts\DialogManager.cs", "C#", 65, 0, 8, 19, 92
"c:\Users\mazap\Desktop\kvalifikācijas darbs\spēle\TheLostSwords\Assets\Scripts\Enemy.cs", "C#", 38, 0, 1, 9, 48
"c:\Users\mazap\Desktop\kvalifikācijas darbs\spēle\TheLostSwords\Assets\Scripts\EssentialLoader.cs", "C#", 27, 0, 1, 6, 34
"c:\Users\mazap\Desktop\kvalifikācijas darbs\spēle\TheLostSwords\Assets\Scripts\ExitArea.cs", "C#", 38, 0, 4, 13, 55
"c:\Users\mazap\Desktop\kvalifikācijas darbs\spēle\TheLostSwords\Assets\Scripts\FadeUI.cs", "C#", 40, 0, 2, 8, 50
"c:\Users\mazap\Desktop\kvalifikācijas darbs\spēle\TheLostSwords\Assets\Scripts\GameManager.cs", "C#", 272, 0, 11, 50, 333
"c:\Users\mazap\Desktop\kvalifikācijas darbs\spēle\TheLostSwords\Assets\Scripts\GameMenu.cs", "C#", 186, 0, 12, 40, 238
"c:\Users\mazap\Desktop\kvalifikācijas darbs\spēle\TheLostSwords\Assets\Scripts\Item.cs", "C#", 65, 0, 3, 14, 82
"c:\Users\mazap\Desktop\kvalifikācijas darbs\spēle\TheLostSwords\Assets\Scripts\ItemButton.cs", "C#", 31, 0, 2, 8, 41
"c:\Users\mazap\Desktop\kvalifikācijas darbs\spēle\TheLostSwords\Assets\Scripts\Knockback.cs", "C#", 51, 0, 6, 7, 64
"c:\Users\mazap\Desktop\kvalifikācijas darbs\spēle\TheLostSwords\Assets\Scripts\LoadingEndScene.cs", "C#", 26, 0, 2, 3, 31
"c:\Users\mazap\Desktop\kvalifikācijas darbs\spēle\TheLostSwords\Assets\Scripts\LoadingNewScene.cs", "C#", 26, 0, 2, 5, 33
"c:\Users\mazap\Desktop\kvalifikācijas darbs\spēle\TheLostSwords\Assets\Scripts\LoadingScene.cs", "C#", 22, 0, 2, 5, 29
"c:\Users\mazap\Desktop\kvalifikācijas darbs\spēle\TheLostSwords\Assets\Scripts\MainMenu.cs", "C#", 38, 0, 2, 10, 50
"c:\Users\mazap\Desktop\kvalifikācijas darbs\spēle\TheLostSwords\Assets\Scripts\PickUpItem.cs", "C#", 29, 0, 2, 6, 37
"c:\Users\mazap\Desktop\kvalifikācijas darbs\spēle\TheLostSwords\Assets\Scripts\PlayerController.cs", "C#", 77, 0, 5, 20, 102
"c:\Users\mazap\Desktop\kvalifikācijas darbs\spēle\TheLostSwords\Assets\Scripts\PlayerData.cs", "C#", 28, 0, 1, 10, 39
"c:\Users\mazap\Desktop\kvalifikācijas darbs\spēle\TheLostSwords\Assets\Scripts\PlayerLoader.cs", "C#", 16, 0, 2, 4, 22
"c:\Users\mazap\Desktop\kvalifikācijas darbs\spēle\TheLostSwords\Assets\Scripts\Pot.cs", "C#", 32, 0, 2, 7, 41
"c:\Users\mazap\Desktop\kvalifikācijas darbs\spēle\TheLostSwords\Assets\Scripts\QuestManager.cs", "C#", 50, 0, 16, 13, 79
"c:\Users\mazap\Desktop\kvalifikācijas darbs\spēle\TheLostSwords\Assets\Scripts\QuestMarker.cs", "C#", 43, 0, 2, 10, 55
"c:\Users\mazap\Desktop\kvalifikācijas darbs\spēle\TheLostSwords\Assets\Scripts\QuestObjectActivator.cs", "C#", 25, 0, 2, 8, 35
"c:\Users\mazap\Desktop\kvalifikācijas darbs\spēle\TheLostSwords\Assets\Scripts\Shop.cs", "C#", 111, 0, 5, 26, 142
"c:\Users\mazap\Desktop\kvalifikācijas darbs\spēle\TheLostSwords\Assets\Scripts\ShopKeeper.cs", "C#", 33, 0, 7, 9, 49
"c:\Users\mazap\Desktop\kvalifikācijas darbs\spēle\TheLostSwords\Assets\Scripts\SimpleEnemy.cs", "C#", 48, 0, 2, 10, 60
"Total", "-", 1603, 10, 132, 364, 2109